NO ./textures/testNO.xpm
SO ./textures/testSO.xpm
WE ./textures/testWE.xpm
EA ./textures/testEA.xpm

F 220,100,0
C 225,30,0

11111111111111111111
1E000000000000000001
11111111111111111101
10000000000000000001
1011111111111111111
10000000000000000001
11111111111111111101
10000000000000000101
10111111111111110101
10100000000000000101
10111111111111111101
10000000000000000001
1111111111111111111