NO ./textures/bonus/CRACK_DEEPSLATE.xpm
SO ./textures/bonus/CRACK_DEEPSLATE.xpm
WE ./textures/bonus/CRACK_DEEPSLATE.xpm
EA ./textures/bonus/CRACK_DEEPSLATE.xpm

F 0,0,0
C 0,0,0

1111111111111111111111111111111111
1B00001000000000000000000000000001
100000D000000000000000000000000001
1111111000000000000000000000000001
1000000000000000000000000000000001
1000000000000000000000000000000001
1000000000000000000000000000000001
1000000000000000000000000000000001
1000000000000000000000000000000001
11111111111111111D1111111111111111
100000000B00000000000000B000000001
1000000000000000000000000000000001
1000000000000000000000000000000001
1000000000000000000000000000000001
1000000000000000N00000000000000001
1111111111111111111111111111111111