NO ./textures/testNO.xpm
SO ./textures/testSO.xpm
WE ./textures/testWE.xpm
EA ./textures/testEA.xpm

F 220,100,0
C 225,30,0

1111111111111111111111111111111111
1B00001000000000000000000000000001
100000D000000000000000000000000001
1111111000000000000000000000000001
1000000000000000000000000000000001
1000000000000000000000000000000001
1000000000000000000000000000000001
1000000000000000000000000000000001
1000000000000000000000000000000001
1111111111111111D11111111111111111
1000000000000000000000000000000001
100000000B0000000000000B0000000001
1000000000000000000000000000000001
1000000000000000000000000000000001
1000000000000000N00000000000000001
1111111111111111111111111111111111