NO ./textures/bonus/CRACKED_POLISHED_BS.xpm
SO ./textures/bonus/CRACKED_POLISHED_BS.xpm
WE ./textures/bonus/CRACKED_POLISHED_BS.xpm
EA ./textures/bonus/CRACKED_POLISHED_BS.xpm

F 0,0,0
C 0,0,0

11111111111111111111111111
1BBBBBBBBBBBBBBBBBBBBBBBB1
1B0000000000000000000000B1
1B0BBBBBBBBBBBBBBBBBBBBBB1
11D11111111111111111111111
11011
11S11
11111