











NO ./textures/testNO.xpm


SO ./textures/testSO.xpm
WE ./textures/testWE.xpm
EA ./textures/testEA.xpm

F 220,100,0
C 225,30,0

11111111111111111111111111
10000000001100000000000001
10110000011100000000000011
10010000000000000000000011N
11111111101100000111000001000001
10000000001100000111011111111111
11110111111111011100000010001
11110111111111011101010010001
11000000110101011100000010001
10000000000000001100000010001
10000000000000001101010010001
110000011101010111110111100111
11110111 1110101 101111010001
11111111 1111111 111111111111







