NO ./textures/testNO.xpm
SO ./textures/testSO.xpm
WE ./textures/testWE.xpm
EA ./textures/testEA.xpm
F 220,100,0
C 225,30,0
 1111 111
1N00010001
 111000111
    111