





    EA ./textures/testEA.xpm
     NO    ./textures/testNO.xpm
WE ./textures/testWE.xpm
          F 32,255,3


               SO          ./textures/testWE.xpm

C 111,111,111








1111111111111111111111111
100000000110000000000001
1011000001110000000000001
1001000000000000000000001
111111111011000001110000000000001
100000000011000001110111111111111
11110111111111011100000010001
11110111111111011101010010001
1100000011011011100000010001
10000000000000011000W0010001
10000000000000001101010010001000000000000             111111111
11000001110101011111011110 0111
11110111 1110101 101111010001             1111     1111111
11111111 1111111 1111111111111111111111111111111   11111111111









