NO ./textures/testNO.xpm
SO ./textures/testSO.xpm
WE ./textures/testWE.xpm
EA ./textures/testEA.xpm
F 220,100,0
C 225,30,0

1111111111111111111111111
100000000110000000000001
1011000001110000000000001
1001000000000000000000001
111111111011000001110000000000001
10000000001100000111011111111111
11110111111111011100000010001
1111011111111101110101001000
11000000110101011100000010001
1000000000000001100000010001
N0000000000000001101010010001
11000001110101011111011110 0111
11110111 1110101 101111010001
11111111 111111 111111111111