NO ./textures/testNO.xpm
SO ./textures/testSO.xpm
WE ./textures/testWE.xpm
EA ./textures/testEA.xpm
F 220,100,0
C 225,30,0


11111
10S01
10001
101111111111111111 
1000000000000000001111
111111111111111111 