NO ./textures/testNO.xpm
SO ./textures/testSO.xpm
WE ./textures/testWE.xpm
EA ./textures/testEA.xpm
F 256,100,0
C 225,30,0

1111111111111111111111111
100000000110000000000001
1011000001110000000000001
10010000000W0000000000001
111111111011000001110NN00000000001
100000000011000001110111111111111
11110111111111011100000010001
11110111111111011101010010001
11000000110101011100N00010001
1000000E00000001100000010001
100000000000S0001101010010001
11000001110101011111011110 0111
11110111 1110101 101111010001
11111111 1111111 111111111111