NO ./textures/testNO.xpm
SO ./textures/testSO.xpm
WE ./textures/testWE.xpm
EA ./textures/testEA.xpm
F 220,100,0
C 225,30,0

1111111111111111111111111
100000000110000000000001
1011000001110000000000001111111
10010000000000000000000011111111
000000000001
10000000001100000111011111111111
00010001
0000000000000001101010010001
11000W01110101011111011110 0111
1 11111111111